fqt: bzs, sfj, nns, gvb, gcd
bzs: fqt, dxr, flq, ztq
pbl: jkk, zmp, zhg, mzf, mfl
jkk: pbl, zdv, pxc, bpm, cqc
zmp: pbl, krh, pzn, fcj, qbs, rpx
vkq: lqr, bps, skm, phr
lqr: vkq, vzh, klk, dsx, zns
tlk: jcs, ddq, nkt, vfh, gfz
jcs: tlk, lbs, nzh, xgs
ddq: tlk, djm, qqt, xsl
nkt: tlk, zqt, jfp, dsc, nvj, xrq
vfh: tlk, jgq, lvv, tjg, vms
hhp: qlf, qtf, jqv, pbq
qlf: hhp, zhk, dpt, hbx, zql, dzf
zxv: jxj, vlm, fmb, mpm
jxj: zxv, rrz, fmb, xpm, jmk
vlm: zxv, lzc, kfh, gqn
fmb: zxv, jxj, gsq, jzh, hbn
mpm: zxv, vbb, pqh, xdg, brv
qtg: vzg, cjz, lhz, cmk
vzg: qtg, dgb, vms, knr
bxf: ddb, lxs, rfq, pzg, gsr, mhg
ddb: bxf, mfg, bng, tdq
lxs: bxf, dzm, zdd, lfb
rfq: bxf, qlg, gpl, rgd, jmr
zqt: nkt, mxj, lll, dsr
mxj: zqt, mpx, vrc, mjc
jxd: zsf, rsk, hfk, jnp
zsf: jxd, krm, qbz, qzr
rsk: jxd, rbt, tkh, fvf, mqb
hfk: jxd, mjq, qkh, zvx
jnp: jxd, fdd, vtn, fpd
hsx: nhc, psx, jtj, lkt, mjg
nhc: hsx, mkh, knq, frh
psx: hsx, tpl, ncg, chz
jtj: hsx, ssf, tkv, bjz, vtm, zzm
lkt: hsx, shv, ldj, csq, snj, tsk
rts: thb, gfd, mdk, tqt
thb: rts, dld, clc, hzk
czc: lhf, fmz, rnq, hkq
lhf: czc, jrk, qpq, qpb
fmz: czc, sqs, kbs, qfr
rnq: czc, bbj, mmv, fzd
hkq: czc, stm, vrs, nrh, zgq
lbs: jcs, spk, rft, mmg, lnf
nzh: jcs, zzf, dxl, nss
rzm: rpf, ntt, lgs, kjn
rpf: rzm, rrz, qzj, hxq
ntt: rzm, bhs, zdv, bjk
lgs: rzm, tlh, nfs, csh
ntj: fkd, mbh, bfr, qxz
fkd: ntj, psn, fkq, hcl
mbh: ntj, xgs, lhh, gxf
bfr: ntj, gdv, gjh, hmc, htj
qxz: ntj, hbq, cnx, pmv
lsx: xdf, msv, kxx, tjn
xdf: lsx, tvf, hds, bfh
msv: lsx, fzg, bgn, sbh
kxx: lsx, lpc, glp, zfz, scg
tjn: lsx, qrn, gvl, pqv
hsp: hcb, ptz, nzs, dpv, bdf, ztm, jhd
hcb: hsp, hnc, mxg, hrd, grx
ptz: hsp, qfl, vrk, dpg
nzs: hsp, ldj, jzd, lfg
dpv: hsp, xlv, mfl, sqb
bdf: hsp, tsz, pbq, dhl
bdv: zbf, spp, zzj, tzz, dlc, ttm
zbf: bdv, qdl, qtb, dsd, mlt, qtz
spp: bdv, lbb, xbc, zsn
zzj: bdv, kpf, cbn, hqn
tzz: bdv, vhf, thv, qdr
jbm: ggk, nfc, sqp, nsh
ggk: jbm, msn, frm, fgq
xqx: pjf, fts, bcv, ssc, ppr
pjf: xqx, nhq, tsp, qkm
fts: xqx, nvb, ngg, gnt, hjx
bcv: xqx, mnh, fnz, scz, xzj
ssc: xqx, zld, glb, nbk
mlv: psz, fcs, djx, vbt
psz: mlv, ksg, pvz, xql
fcs: mlv, kvt, jlb, cch
djx: mlv, dld, dkh, kvb
vbt: mlv, zrj, blb, ttm
src: fhv, stv, lzg, qnq
fhv: src, pnv, qzr, ssv
stv: src, szr, hvl, lcm, kzp, cds, krq, pgn, qvm
lzg: src, qfh, lbc, gmr
qnq: src, gzq, rqx, pqp, qkp, rpx
jrk: pmv, kqx, nll, xsj, lhf
pmv: jrk, pgx, fpj, qxz, jkj
kqx: jrk, vfb, bkr, cxl, cxd
nll: jrk, dgb, hqj, pjh
xsj: jrk, ttc, pgx, skv, tmx
hkx: hxr, bhf, xgs, dxr, hvc
hxr: hkx, snt, tmp, tqz
bhf: hkx, qqg, dxm, qnk
prh: pbn, ddz, sng, dsx
pbn: prh, sng, qtb, sdp, bgc
xkg: hcn, hcg, prf, mqr
hcn: xkg, nmd, ctv, tsq
hcg: xkg, fdd, zdd, sbm
prf: xkg, pgz, grd, rxn
ttg: dgl, mxg, fpc, sgz, dmc
dgl: ttg, zcj, cgx, sbn
mxg: ttg, hcb, hrv, djc
fpc: ttg, shv, fxp, pfm, hbn
dql: gtc, jjm, cfn, pfv
gtc: dql, xhk, xgh, nrt
zxs: pxq, xnv, rcf, zrv
pxq: zxs, cbn, xxt, xmh, hpv
xnv: zxs, msg, dgc, kxt
rcf: zxs, sfn, rcp, zdm
zrv: zxs, ppt, vdn, nqn
dgb: lfm, kzx, vzg, nll
lfm: dgb, kbs, ktl, vkb
kzx: dgb, bfh, crp, flq, qmr
pnv: fhv, fdl, bbl, mtl, cgx
bnh: mbc, fdh, kzt, klb
mbc: bnh, ghh, vcp, jqj
rrz: jxj, rpf, bnk, pgn
bnk: rrz, flt, ztb, drv, gnr, lrr
pgn: rrz, hxq, xtc, tsk, stv
jjd: gxt, mcj, ztd, jkq, kkt, trb
gxt: jjd, sdm, bbq, dtr
mcj: jjd, cts, kpb, vsk
fxg: zxj, brd, srq, fcc
zxj: fxg, lzp, msg, dkh, tvf, nlj, rlr
shg: dpk, tnr, vtn, nmz, tlb, gkv
dpk: shg, srs, pgd, zql
tnr: shg, ppm, pms, kxj, ddh, ctx
vtn: shg, zkb, pms, jnp
zzf: nzh, xcl, lhh, cfg
zqr: fkr, tzr, mcp, trp, dzp
fkr: zqr, xqt, nlg, nbj
tzr: zqr, rdb, fzg, jxc
krh: zmp, vlc, pbc, tdh, tzg
xqf: srs, gsl, rxd, ndv
srs: xqf, ptf, dpk, cqc
gsl: xqf, tsz, qsb, qct
nvb: dcf, msn, fts, qdt
dcf: nvb, lhh, fcc, zng
msn: nvb, ggk, jfj, mfh
qsn: bhc, jmc, nmz, shv, cqb
bhc: qsn, bnq, gzc, qkm
jmc: qsn, qcz, qpj, lfx
nmz: qsn, ckt, vht, vkf, shg
hbq: qxz, fjn, cxb, zpt
qkv: kpd, chd, jmk, qtp
kpd: qkv, qhh, vtm, ggt, qvm
chd: qkv, knk, mpb, zxc
mfg: chz, ddb, vtl, rdq
chz: mfg, qjh, psx, fbj
vtl: mfg, tkd, nfb, pkg, fmv, pqk
vgx: cpd, tff, rlf, kvl
cpd: vgx, ssl, ngg, ctv, hnc
csd: mzq, mfh, pzt, dcb
mzq: csd, srv, gxr, hbz
jhf: ztb, rrf, gqm, vjg
ztb: jhf, bnk, rbj, bjz, gcv
rrf: jhf, szr, dlm, cbv, bhs, krq, mgf
gqm: jhf, dqn, xfr, nmc
xbg: vzd, qgg, gpj, mgx, thz
vzd: xbg, bll, gsr, qdp, plg
qgg: xbg, tbv, vlf, jmr
gpj: xbg, jrq, pst, zgm, ljn
fjn: nmg, fdh, bdh, hzk, hbq
nmg: fjn, xhr, dfb, thj
fdh: fjn, bnh, qfz, nlr, qdx
bdh: fjn, xnf, qpq, mkg, lbb
hzk: fjn, jqh, thb, kpl
qtf: tcx, hhp, zvx, jfd
tcx: qtf, lqh, pzn, ndc, rpb
zvx: qtf, gsq, cvf, tmz, hfk
qcz: jmc, sbg, ddh, xrl, ksh
dsz: ppt, vkk, jfx, prg
ppt: dsz, grl, xqz, vzv, zrv, ltn, knr
dpl: gjf, ggx, hpd, hvf
gjf: dpl, sdm, psn, jkq
bxb: fmh, fkq, gxp, lkh
fmh: bxb, kpl, ckg, snt, mnk
fkq: bxb, qqg, pcc, fkd
gxp: bxb, zcb, vgr, vgf
prd: ghh, lmq, fzm, cfh
ghh: prd, kvh, dbn, jcx, jkh, mbc
lmq: prd, tjq, jfj, trz
gsq: zvx, fmb, sdx, rgc
gxf: kkr, pkh, vgv, pjm, dnf, mbh
kkr: gxf, hhs, chm, hjs
pkh: gxf, jzf, ffq, bkg
vgv: gxf, thh, dqc, ppp
pjm: gxf, gfl, kfn, kmf
dnf: gxf, jpq, tjk, zgz, tkf
fzd: jfj, lxb, pnh, rdn, rnq, tmp
jfj: fzd, msn, lmq, lgj
lxb: fzd, tpf, gdn, glr
pnh: fzd, hgp, mtb, jjl
vkk: dsz, kcc, sgc, kpk
hqx: djm, fsk, vmq, vsq, htj
djm: hqx, ddq, cfn, dlj, vvg
zrj: vbt, lch, lrs, dqj, srv
lch: zrj, mdx, rtt, fcf
lrs: zrj, zxz, kfn, kpf, qxr
dqj: zrj, lst, xhv, kfq
srv: zrj, lss, tjb, kfs, mzq, qmp, kgk, nkh
thh: vgv, zbx, qmj, mgd
zbx: thh, xfc, xql, vrc
qmj: thh, fsc, qxr, vdn
mgd: thh, blc, lst, xql
ccj: qvb, lxn, trt, qjc
qvb: ccj, tdq, nfl, nzq
hbc: tkh, ndv, nxv, grx, bxm
tkh: hbc, rdj, rsk, sbn, gbl
pgr: jxz, vbr, xxs, rjp
jxz: pgr, lhb, rpx, hdq
vbr: pgr, hqp, hgd, nhq
xxs: pgr, xtk, zqh, pqm, dvg
rjp: pgr, mqr, kfh, slv
mkg: jgq, mtb, bdh, kpk
jgq: mkg, vfh, mzm, zfz
xnd: dng, bpb, pcb, vmh, kvm
dng: xnd, sxv, qgp, pqv
bpb: xnd, lbh, lqx, zpt
rbl: znp, ksx, gnt, lrr
znp: rbl, tpl, npk, bcz
ksx: rbl, bxp, dzm, qds, tlm
zxz: ljg, lrs, kvh, mfh
ljg: zxz, kpl, hhj, gfz
vtj: ltn, ktl, kxt, tzp
ltn: vtj, xvt, hfd, ppt
ktl: vtj, lfm, ncp, sbh, tqz
kxt: vtj, mfc, xnv, cmt
ssf: zfd, njn, mxv, jtj, qxf
zfd: ssf, fdd, klz, tsq
njn: ssf, ppr, mbq, jvc
mxv: ssf, dkm, hqp, ptf, cvc
qxf: ssf, rhd, qjx, rqk
bxp: ksx, nbv, zfg, stl
zhg: pbl, phs, gmf, brv
phs: zhg, csh, gnx, kfh, ssv
szr: hnc, qhh, stv, rrf, qkm
hnc: szr, xgn, hcb, cpd, hvn
qhh: szr, gzd, ztm, kpd
kmz: bsb, lcb, glr, xsd, qdx
bsb: kmz, lzq, qdr, htj
lcb: kmz, cdp, bzm, nsh
lvv: vfh, jrp, shh, bkg
tjg: vfh, xdl, rft, xqg
vms: vfh, vzg, xjn, xtg
tvx: ztq, mfc, tqq, lgk
ztq: tvx, jpf, smq, tzk, bzs
mfc: tvx, kxt, lgk, mhp
jpq: nbj, xxv, dnf, fnb
nbj: jpq, sbs, tmx, zdm, fkr
xxv: jpq, vng, nss, hvf
fnb: jpq, qfz, lnm, ffq, dvz, pcv
rhd: qxf, bnv, cmz, csh, tpt
jdn: rcb, bvm, kmh, hvn
rcb: jdn, mnh, mdq, zdd
bvm: jdn, klz, rfh, lbk, djc, nfs
kmh: jdn, qkp, zvg, pns
zst: mfn, prr, xcv, jss
mfn: zst, hmq, stb, grl, skv, gnj
prr: zst, mmv, brd, ntq
xcv: zst, sjz, fgs, bbb
qrz: bll, pgz, rxd, fcj
bll: qrz, drm, vzd, tqd
pgz: qrz, prf, thz, cds, rql
hqj: nll, mjv, gck, pqg, dzp
mjv: hqj, sqp, frm, dxm, vsc
gck: hqj, jrp, xqt, zgq
pqg: hqj, fqm, nnr, tlc, hgk
vzh: dxl, xqg, lqr, jkq
dxl: vzh, lfc, jlb, nzh, mjk
xqg: vzh, xcl, thv, trp, vsk, jgg, pjj, tjg
dkm: vth, mxv, vcz, bnq, zdv
vth: dkm, gmz, kgz, cmq
vcz: dkm, gtm, pkj, vfn
bnq: dkm, rzn, vlc, bhc, nfs
zdv: dkm, hkj, jkk, ntt, qnz, hsr, qdp
tmd: trt, krn, pzv, qgb
trt: tmd, ccj, pkm, ksh
krn: tmd, cdj, tsg, dpg, crl
pzv: tmd, tmz, gnc, czp
qgb: tmd, fjh, hps, crs
vvn: hbs, ckg, cxb, jrz, zns
hbs: vvn, lnf, jqh, fvv
ckg: vvn, fmh, kvn, pcv, njz
tlh: skp, zbl, lgs, cqc
skp: tlh, fvg, fkc, hcc, qpv, ckt
zbl: tlh, hrv, hmt, npk
qqp: lgj, cdp, ccd, gcg
lgj: qqp, jfj, mqh, hjh
shz: pvn, fpm, htk, gkq
pvn: shz, mlf, qlb, kks, kzh
tjs: ljl, trz, hls, bxx
ljl: tjs, ksg, ztd, qqg, lhz
trz: tjs, lmq, pzj, tqj
hls: tjs, tqq, qfp, pjj, mmg
qqg: bhf, cns, fkq, ggx, ljl
cns: qqg, gmj, qfp, jss
kzl: zvg, jtg, zcj, knq
zvg: kzl, dpt, kmh, bxv
jtg: kzl, zzm, lhj, cmz, rns
xcl: xqg, dhp, zzf, rjq, bhb, kpk
dhp: xcl, kgd, dcp, sgh
rjq: xcl, tpf, hbl, xtd
bhb: xcl, xbz, xph, thj
mtq: qpb, fbc, rhn, hhs
qpb: mtq, snv, dfb, lhf
fbc: mtq, mht, mtc, gjh
rhn: mtq, mpx, mfp, jjm, bbq
xpn: cds, hqp, xlv, gst
cds: xpn, qbh, stv, vpj, pgz
ssm: pbc, qln, cjt, npk
pbc: ssm, dss, klz, krh
qln: ssm, jqv, mdq, plb
cjt: ssm, sfs, brv, vfn
npk: ssm, nrf, qzr, pns, zbl, znp
drm: bll, rhh, vch, fbq, mtf
rhh: drm, ssk, hcc, qhf, kgz, fbj
jjx: zfg, msm, ndc, qbb
zfg: jjx, zvn, bxp, rlf, xdh
msm: jjx, rgc, xzj, znd
ndc: jjx, mqd, tsp, tcx
csh: phs, lgs, rhd, slv, qtk, xmm, sbj
ftr: tff, tst, xnj, nkc, pxc, rzz
tff: ftr, vgx, hjx, mkv
tst: ftr, qbz, jxx, vpj
xnj: ftr, stp, jff, pns
pfb: hcl, zgq, mtc, hql
hcl: pfb, hph, fkd, vzb
zgq: pfb, xcr, hkq, gck
spk: lhh, bgn, lbs, nqn
lhh: spk, zzf, mbh, bbv, dtn, dcf
bgn: spk, lzq, smg, fdq, msv
cpf: vgn, tbc, cqb, hhl, zmd, sfp
vgn: cpf, tsp, bxm, gdx
tbc: cpf, cvj, jgc, xtk
cxh: hcq, gst, jdm, jxx, vps
hcq: cxh, qbz, khr, fxr
gst: cxh, nzq, kzp, xpn
jdm: cxh, gsr, lfb, ssk
jxx: cxh, ssk, vjt, tst
vps: cxh, dzf, mtl, hbh
sfj: ffq, fqt, dxp, ndq
ffq: sfj, dbn, pkh, fnb, nss
dxp: sfj, dtn, rvq, thj
klk: bbv, lqr, jpd, cxk, tgv, ckf
bbv: klk, tlc, lhh, jqj
zld: xpz, gbr, ssc, zql
xpz: zld, vpj, nrf, jsn
gbr: zld, xzj, fjh, qjd, fbj
zql: zld, bjz, dpk, qlf
klv: shh, tqh, kpl, qdl, bbb, blv
shh: klv, rdk, mzm, lvv
tqh: klv, hgp, xgj, gxc
kpl: klv, kkm, xhr, fmh, ljg, zjr, hzk
xnn: czl, xcq, nfl, tbx, jhd
czl: xnn, gkr, qmr, txj
xcq: xnn, hdq, gjb, mhd
nfl: xnn, fkc, lzc, tsp, qvb
tbx: xnn, snc, zmd, rql, crj
csc: bsj, bhj, zlc, knq
bsj: csc, bng, jgc, jnz
bhj: csc, msk, dzf, crj
zlc: csc, xsx, dss, mkk
fpm: rns, xdz, xdh, shz
rns: fpm, jtg, vmb, hzb, pqh, pdf, mqr
xdz: fpm, zmm, snr, qzh
xdh: fpm, zfg, vmb, jsn
nfc: jvx, chm, ccd, qtx, jbm
jvx: nfc, kvh, zhr, glr
chm: nfc, dxr, mvf, rmt, kkr, zjr
ccd: nfc, xxt, qqp, nlb
qtx: nfc, hhs, hhj, tcg, rvq
bjk: hbh, vlq, snc, ntt, tbs, jjz, klr
hbh: bjk, kxj, svm, vps
dsx: lqr, bgb, tmp, dpf, prh
klz: bvm, cmz, zfd, pbc
cmz: klz, rhd, jtg, grd, lbk, bxh
sdm: gxt, vdr, gjf, vng
vdr: sdm, lnf, fsc, jdg
tvh: vkh, hrv, rpp, xxl
vkh: tvh, sgm, gjc, mgf
hrv: tvh, gkr, zbl, mxg, snj
gzd: qhh, qxp, znm, dmc
ztm: qhh, xxl, hsp, nzk, frh
ssl: cpd, pqp, kks, mrl, kjn
pqp: ssl, qsf, mrj, hmt, qnq, xjp
kks: ssl, qkh, vjv, pvn, cbv
cmf: vgr, llz, xhk, btj, vsc
vgr: cmf, gxp, rgs, bbb, pvf
llz: cmf, kfq, gzk, cjs
zjf: zpl, gtg, lpp, kkq, dcp
zpl: zjf, zrc, fqm, xkb
gtg: zjf, jtd, glp, zsn
lpp: zjf, mlt, chs, hmc, vvg
kkq: zjf, ndq, hjs, pkb
tpl: znp, plb, psx, qpg, sgz
plb: tpl, pfm, qln, ftx
qpg: tpl, jgc, rxv, fvm
kvh: ghh, zxz, jvx, jpd
ghl: rxd, rxn, qdq, vjv, mbq
rxd: ghl, qrz, xqf, mxp, kjn
rxn: ghl, mlf, vlf, prf
qdq: ghl, tnf, vvl, qcn
vjv: ghl, xpm, zmd, kks, qqc, lfx
mbq: ghl, njn, gmr, xzj
hbg: xvt, pjv, qcp, lzp
xvt: hbg, nlr, ltn, kzm
pjv: hbg, rfp, lzv, qdr, qnk
xxl: ztm, jvc, tvh, hrd
nzk: ztm, bbp, zzm, xlv, svm
frh: ztm, tpt, nhc, txj
kfq: llz, xpf, skm, hbl, xpt, dqj, dqm
mpx: mxj, fjm, rhn, zvc
fjm: mpx, gzk, bkr, mdx
vzf: nss, nzl, kdg, xft
nss: vzf, bgl, nzh, hhj, lcs, ffq, xxv
nzl: vzf, hct, pgx, bbj
kdg: vzf, bxl, mjk, dlj
xft: vzf, cts, pzj, msh, bgb
vjb: nzm, mgv, kcr, xhj
nzm: vjb, mhf, kfj, xdg, qgm, dxh
mgv: vjb, jkf, rfh, zfx, rnn, skf
kcr: vjb, btd, dvg, rqk, fhl
xhj: vjb, gkr, dlm, nmf, fdk
znh: lhm, mzm, zpx, dpf, mdv
lhm: znh, mcp, cfk, xbz
mzm: znh, jgq, qrt, jkq, shh
zpx: znh, jmm, lkh, sgh
dpf: znh, hvc, bzv, dsx
mdv: znh, zrr, kmb, xgq
lnf: xfc, hbs, vdr, lbs
xfc: lnf, lbb, zbx, smx, hvm
qsf: pqp, qcx, hzn, kjn
xgn: vkf, tpt, hnc, thz, sqb
vkf: xgn, rfh, nmz, gbn, qbb
tpt: xgn, lqs, rhd, frh
cdt: zgm, zgd, kps, stl
zgm: cdt, rpp, gpj, qnz
zgd: cdt, pfm, mxp, mlc
ncg: psx, czp, cvs, zcr
czp: ncg, sbg, cms, pzv
bbp: nzk, rhv, ggt, jgc
rhv: bbp, tsx, grx, nmf
ggt: bbp, flt, vrk, rjd, blg, kpd, qtk
jgc: bbp, bsj, cgx, tbc, qpg
shv: lkt, rpd, fpc, dqf, qsn
rpd: shv, hvl, lrr, bml
dqf: shv, pxc, qbs, gqr, nmc
cts: kgj, xft, mcj, tgg
kgj: cts, rfp, jhq, fbd, qtv
tgg: cts, gfl, xpf, xtd
zhk: kqr, qlf, qgm, flt
kqr: zhk, tkv, ghv, btd, brv
qgm: zhk, nzm, mkv, dhl
ldj: qzh, rxc, lkt, nzs, qjh
qzh: ldj, qbb, jvc, xdz
rxc: ldj, tzd, rcs, bxv, vmb, xrm
qjh: ldj, pps, chz, dpg, pkm
pzj: xft, zjc, trz, bsh
qlg: rfq, ddh, bck, nmf
zcj: dgl, kzl, nmc, mpb, pzg
nmc: zcj, gqm, dqf, msz
mpb: zcj, chd, bjz, lrn
pzg: zcj, hxq, bxf, jrc
tkv: jtj, jnj, gmf, kqr
jnj: tkv, nkc, lfg, hcv
pth: jbx, lcs, dld, bzv, mgj, qrn
jbx: pth, xsd, gcd, vml
lcs: pth, nss, tzk, xbt
dld: pth, zrr, thb, djx, rdm, tcg
bzv: pth, mdx, xjf, dpf
mgj: pth, xhk, rgs, zqv, cfk, bzm
dxg: jgg, trb, vlh, sfn
jgg: dxg, bbb, rlq, xqg
trb: dxg, ngz, vgf, jjd
vlh: dxg, tqq, bcs, ggx
sfn: dxg, rcf, hrt, mfp
kpf: pnb, lrs, mdk, zzj
pnb: kpf, cjz, dvz, fzm, hvf
hmq: qxn, mfn, jfx, mcl
qxn: hmq, nhr, xpt, qdr
hrd: hcb, fdl, rbq, xxl
tsp: vgn, zkb, jcp, ndc, hsr, nfl, pjf
bxm: vgn, tbv, zcr, hbc
qpq: hjh, lhf, bdh, hpv
hjh: qpq, brq, gnj, lgj, dcb
znm: xrl, trl, pvc, gzd
xrl: znm, qcz, qct, xcg
hht: xtm, mvx, rgd, tsx
xtm: hht, xvv, mzn, sbg, mhf
mvx: hht, scv, qds, jmr
jqv: qln, xrv, hhp, rzn, fbt
xrv: jqv, plq, ppm, ksb
rzn: jqv, cdd, hkj, mgx, bnq, fbq
mxx: xbt, tbn, snv, nlb
xbt: mxx, spq, mtr, zxq, lcs
xhv: hds, snt, nvj, dqj
hds: xhv, tjk, xbz, xdf, dfb
snt: xhv, hxr, fmh, pvz
qfz: xxr, fnb, fdh, cxk
xxr: qfz, nhr, svn, bfq, sdf
mht: fbc, tjb, hpd, jbj
hgp: djb, pnh, tqh, jfp, llr
djb: hgp, mxq, xjz, bcb
jfp: hgp, nkt, dqc, zqv, xph, zns
llr: hgp, psl, bgb, qjt, vcp
stm: hkq, znz, fgs, sdp
znz: stm, qfp, hvm, zgz, fcc
fgs: stm, xcv, mbd, rqz, gmn
sdp: stm, glp, pbn, mcv, ntq
mfz: vrs, vxn, xdr, qdr, zxl
vrs: mfz, kfp, hkq, pjj
vxn: mfz, blc, qdr, vkl
xdr: mfz, ggh, bbj, jjl, fxq, nrt, kvm
qdr: mfz, vxn, qxn, pjv, bsb, tzz
zxl: mfz, zrc, xpt, zng, bxx
rfh: nfq, vkf, bvm, mgv
nfq: rfh, knq, zdd, pkm
hvl: stv, djq, rpd, sfp
jrq: mlf, gpj, bhn, sgm, lrn, knq
mlf: jrq, hkj, pvn, thf, ksb, rxn
bhn: jrq, cvf, pdf, vlc
lss: srv, bfh, cfg, brd
bfh: lss, kzx, vkb, xdf
rqm: zgz, mtr, llv, nqn
zgz: rqm, gcd, znz, dnf
fvg: gjb, fxp, skp, kvl
gjb: fvg, tlb, xcq, txj
fxp: fvg, nbv, tzg, lxx, fpc
rdq: crk, nmf, mfg, cvc
crk: rdq, gmf, bhs, hgx, xhn
nmf: rdq, xhj, xrm, rhv, dqp, qlg
qhn: sdf, lzq, tlc, tgc
sdf: qhn, btj, xxr, fpb
zhr: jmh, jvx, pkb, hbt
jmh: zhr, tpf, hzg, rdb
pkb: zhr, sng, mhp, xpf, xkb, kkq
rfp: pjv, jnf, kgj, zdj, gcg
jnf: rfp, gdv, qff, bkg, xtd
flt: zhk, ggt, bnk, xcn
xcn: flt, zfx, tmz, cks
bjz: jtj, ztb, mpb, hzb, zql, bml
vtm: jtj, kpd, mqb, xtk
qfl: xhh, lhj, ptz, bpm
xhh: qfl, gcx, tqd, dlm, spr
lhj: qfl, cpm, jtg, vhx
pvz: fcf, snt, gsz, psz
fcf: pvz, bps, clc, chs, lch, kdh
bnv: bml, rhd, pxc, ljn
bml: bnv, khh, bjz, rpd
dlm: rrf, xhh, ppm, skf, xhj
cbv: rrf, znq, kks, bjf
jpd: klk, sxv, kvh, pcb
sxv: jpd, flq, bcs, dng, jcx, lnm
pcb: jpd, zrr, xnd, hsn
xhk: vcr, gtc, cmf, pnd, mgj, zhm
vcr: xhk, jfv, lzv, jqj
pnd: xhk, dkh, cxl, dvz
zhm: xhk, tpf, bgl, hsn
tfm: kvt, dgc, rdn, pmp
kvt: tfm, xph, fcs, knr
dgc: tfm, xnv, jdg, cmk
rdh: gmz, lbc, ksb, nzq, rnc
gmz: rdh, jzh, vth, gnr, bjf, qbs
lbc: rdh, xpm, lzg, mgf
ksb: rdh, mlf, xrv, ctv
nzq: rdh, vlq, skq, gst, qvb, msz
msz: zkb, nfb, nzq, nmc
zkb: msz, vtn, tsp, gzc
nfb: msz, vtl, cvj, zmm
dzm: cvj, ksx, trl, lxs
cvj: dzm, tbc, nfb, pfm
trl: dzm, znm, qqc, pns, lfx
krm: tnf, zsf, crs, ftp
tnf: krm, ckv, mzf, qdq
crs: krm, qgb, pkj, btd
ftp: krm, ktk, gcv, rxv
gfd: bkb, rts, nlg, jtd
bkb: gfd, gdv, tnb, hpv
nlg: gfd, jfx, rsq, mxq, fkr, kpg
vhf: tzz, tgv, bjb, thq, gnj
kkm: dtr, kpl, brq, kgd
dtr: kkm, ktt, gxt, lst, hbz
brq: kkm, ztd, cxb, hjh
xgs: jcs, hkx, mfh, mbh, kbs
mfh: xgs, ncp, vdq, msn, dnk, zxz, csd, smq
kbs: xgs, lfm, fmz, vsk, hvc
crp: kzx, xdl, ttc, vmq
flq: kzx, sxv, bzs, qfj
qmr: kzx, gcx, czl, qzn
jhq: kgj, dsd, tqq, jjm
dsd: jhq, lzp, kpg, zbf
tqq: jhq, qrn, tvx, hls, vlh
jjm: jhq, dql, rhn, hgk
vng: hgr, sdm, kmf, xxv
hgr: vng, nnr, sbh, xsz
kmf: vng, dxr, pjm, hmc, cfh
rzk: vfb, ppc, qfp, gxc
vfb: rzk, xbc, kqx, fdq
ppc: rzk, pzm, cfk, fsk
qfp: rzk, cns, hls, znz, dxm
tsz: xhn, gsl, mkh, bdf, mtf
xhn: tsz, crk, zvn, qtp
mkh: tsz, ktk, gzc, nhc, plq
qzj: pnz, rpf, tkd, crj
pnz: qzj, nfs, jfr, qjd
tkd: qzj, vtl, grd, ngg
crj: qzj, tbx, pst, bhj
qxp: glt, znq, xgm, gzd
glt: qxp, hmh, xfr, zfx
scv: mvx, ghv, vzl, stp
ghv: scv, kqr, qmb, qjc, tsg
vzl: scv, qpz, fpd, qqq
stp: scv, vlq, qcn, xnj
znq: qxp, cbv, lzc, txm
psl: lnm, vcp, llr, bbq, skl, tfc, fjp
lnm: psl, fnb, sxv, jjl
vcp: psl, jtd, llr, mbc
bbq: psl, gxt, rhn, fxq, nvj
lpc: kxx, kqm, cxd, dlc
cdp: lcb, knr, qqp, jgs, cmt
knr: cdp, lzq, sfz, kvt, vzg, fpb, ppt
mnh: vfn, rcb, bcv, mrp
vfn: mnh, cjt, vcz, xcg
kfp: vrs, bjb, mqh, qnp
bjb: kfp, sqp, rgh, vhf
fhr: rpb, jmr, lnq, blg
rpb: fhr, kzp, tcx, gnr
jmr: fhr, qgg, rfq, mvx, crc
xdl: sbs, tjg, crp, hzg
sbs: xdl, cnn, thq, nbj
xjn: vms, sqs, ctc, dtf, mhp
zzm: fmd, jtj, jtg, nzk, nxx
fmd: zzm, gtm, qkh, fvf
nxx: zzm, qbh, lnq, htk
hct: fxq, sjk, tjq, mdk, nzl
fxq: hct, xdr, bbq, ckf
sjk: hct, dqm, vzv, tmp
tjq: hct, lmq, dtl, gfl
mdk: hct, rts, xcr, kpf
sld: hzn, hmh, rxv, glh
hzn: sld, xtc, qsf, jrc, qdp
ckv: tnf, dpt, vdb, kzh
cdd: mzn, tsj, dqz, rzn
mzn: cdd, xtm, fms, pst, ctx
tsj: cdd, lzl, fbq, sct, xrm
dqz: cdd, rgd, lbk, sct
gfl: pjm, tgg, tjq, nlr, bcb
rdm: tmx, dld, fzg, fpk
tmx: rdm, zrc, xsj, nbj
rdb: tzr, fsc, jmj, jmh
gpp: pkj, glb, lqh, tss
pkj: gpp, ldk, qfh, crs, vcz
glb: gpp, mrl, txx, ssc
lqh: gpp, szx, csq, tcx, txj
tss: gpp, fdl, tbv, qvm
lbb: xfc, spp, xpl, bdh
zrc: zpl, zxl, skm, tmx, bgc
skm: zrc, vkq, njz, kfq
ddz: prh, bzm, nrh, svn, mtr
fkc: rqx, skp, nfl, qdp
rqx: fkc, qnq, thf, njj
gmf: zhg, jql, tkv, crk
jql: gmf, mdq, sbj, gbl
gnx: phs, lzl, mqb, pkm
rgs: mgj, vgr, zsz, cfh
zqv: mgj, klb, jpr, jfp, tgc
cfk: mgj, vml, lfc, ppc, lhm
bzm: mgj, lcb, ddz, thj
kxj: rbj, hbh, ldk, tnr
rbj: kxj, ztb, spn, glh
mrj: pqp, zqh, tbv, gdx
zqh: mrj, xxs, zvn, mhg, rql
tbv: mrj, bxm, qgg, tss
hjx: tff, qpj, fts, bpz
vpj: xpz, lqs, tst, qsp, cds
qcp: rmm, ndq, hbg, rft
rmm: qcp, flp, jkr, frq
ndq: qcp, kkq, klb, sfj, gcg, mhp
qbh: nxx, cds, gzq, dmc
fbt: xtk, jqv, sqb, qlb
xtk: fbt, xxs, rgd, tbc, vtm
sqb: fbt, pdf, lnl, xgn, dpv
xph: kvt, dbn, xbr, bhb, jfp
cpm: lhj, hgd, lrz, mqd
pzm: fxb, vfc, tkf, ppc, rqz
fxb: pzm, tlc, skl, hbl
vfc: pzm, bgl, ggx, cxd
tkf: pzm, phr, jkh, ttm, dnf
rqz: pzm, jht, xgh, fgs
xvv: xtm, mjg, qnz, drv, njj
lxn: bjf, fvz, ccj, hgd
bjf: lxn, gmz, kjn, cbv
fvz: lxn, bzp, tlm, cvc
jzh: fmb, nmd, snr, gmz
nmd: jzh, vdb, hcn, jvc, lhb
snr: jzh, xdz, qtp, vkc
cvf: jtr, zvx, xpp, bhn
jtr: cvf, sfs, ndv, tsb, lcm
xpp: cvf, krq, qkm, njj
hmh: glt, sld, tqd, bzp
tqd: hmh, xhh, ktk, nxf, mqr, bll
dpt: qlf, ckv, cgx, pfm, zvg
cgx: dpt, nfs, dgl, jgc, pnv
pfm: dpt, zgd, fpc, plb, cvj, pgd
fdd: hcg, zhv, jnp, zfd
zhv: fdd, skq, ptm, pln
mjk: zlq, dxl, kvn, kdg
zlq: mjk, zxq, tpn, mdx, rlr
tjb: mht, hvm, srv, xpl, zjc
hvm: tjb, znz, xfc, zdm
ssk: rhh, jxx, vrk, pgd, jdm
hzc: qxr, pvf, fvd, pjz
qxr: hzc, qmj, lrs, gvb
pvf: hzc, rmr, vgr, bcb
kfs: srv, kgk, hzg, tqz
nbv: fxp, hnt, fdk, bxp, vjt
hnt: nbv, mdq, zmq, ptm
fdk: nbv, ptf, xhj, gqn
vjt: nbv, jxx, vjg, trs
sgm: gbl, jrq, vkh, mhg
gbl: sgm, crc, jql, tkh
mhg: sgm, zqh, bxf, xmm
kps: cdt, mjq, tsf, snc
mjq: kps, ckt, hfk, qjc
tsf: kps, xfr, dvg, vch
blc: vxn, mgd, mtb, dsr, zpt
khh: bml, djc, nkq, gdx
djc: khh, sbg, gpl, bvm, mxg
nfs: lgs, cgx, tdh, pnz, bnq, bvm
qpz: lnl, fjh, vzl, djq
lnl: qpz, pps, gnc, sqb
fjh: qpz, fhl, qgb, drv, gbr
djq: qpz, srh, tzg, hvl
gmj: xbz, cns, brd, rtg
xbz: gmj, vqp, hds, bhb, tnb, lhm
kfn: pjm, lrs, dlj, hlx, gxr
dlj: kfn, kcc, rcp, fpb, djm, rlq, kdg
hlx: kfn, bxl, jmj, vzb, pfv
gxr: kfn, fdq, mzq, jpr
gzk: llz, fjm, ngz, jqj, fvv
cth: gmn, xbc, jxc, blv
gmn: cth, rmr, qfj, xbd, fgs
stb: mfn, skv, bfq, dqm
pqm: xxs, qkp, rnc, gmr
dvg: xxs, bng, kcr, tsf
sfs: jtr, cjt, ksh, spr
ldk: kxj, pkj, pbq, dmc
pbq: ldk, mtp, hhp, pdg, bdf, xbk, bng, tmb
jjj: sfd, thq, hrt, jfv
sfd: jjj, khb, rmr, gcg
thq: jjj, sbs, tqt, vhf, jbj
hrt: jjj, kzm, sfn, msh, gxh
rpp: zgm, tvh, jfr, bhx
vdb: nmd, xgv, ckv, sdx, stl
xgv: vdb, dbd, gkq, dqp, rbq
mlt: lpp, cnn, sgh, zbf
cnn: mlt, thv, sbs, lrb
xkb: fqm, nxh, nns, pkb, zpl
fqm: xkb, pqg, vkl, zpl
zqb: skv, xgq, frq, hbz
skv: zqb, mfn, stb, xsj
vlq: nzq, bjk, stp, xlv, qvm
hkj: rzn, mlf, gbn, zdv
gbn: hkj, trs, jjz, vkf
jht: rqz, tjk, xsg, ckj
bps: vkq, gxc, ctc, fcf
gxc: bps, kgd, nsc, tqh, rzk
ctc: bps, fjf, xjn, cnd
xjz: vxd, gnj, xtg, djb
vxd: xjz, tbn, vqp, hvf
gnj: xjz, hjh, vhf, mfn
svm: hbh, ndv, mss, nzk
xpl: tjb, lbb, jpm, nkh, xsl, blv
fhl: qkx, fjh, htk, kcr
qkx: fhl, jtk, cmq, xmm
nzc: jrc, xrm, tlb, lzc
jrc: nzc, pzg, zmm, hzn, gnr
xrm: nzc, tsj, rxc, nmf
sjz: xcv, mcp, hpf, sfz
lfc: dxl, cfk, jzf, jlb
jlb: dxl, fcs, fsk, lfc
kcc: bmp, xgh, dlj, vkk, dnk
bmp: kcc, jdg, sfz, xhr
xgh: kcc, rqz, xql, gtc, kzt
hqp: vbr, xpn, lxx, qzn, mxv
lxx: hqp, dqn, fxp, btd
qzn: hqp, mrl, qmr, snj
mmv: ggh, prr, rnq, jbj
ggh: mmv, jgs, tfc, mqh, xdr
xql: zbx, xgh, mgd, psz
lqg: lzv, ppl, pcv, srq
lzv: lqg, pjv, vcr, gcd
ppl: lqg, mcv, qnf, kqm, tgc
pcv: lqg, xsd, fnb, ckg, svn
ncp: xnf, smq, ktl, mfh
xnf: ncp, pjj, pjh, bdh, qdx, sfz
smq: ncp, tct, ztq, fdq, mfh
kgd: nrt, dhp, gxc, kkm
nrt: kgd, tpf, gtc, xdr
xvp: chs, msh, qnf, tqz
chs: xvp, lpp, gvb, fcf
msh: xvp, xft, lqx, hrt
qnf: xvp, jmm, ppl, hzg
zcb: gxp, mtc, xmh, qtz
rft: frq, tjg, qcp, lbs, cxb
frq: rft, zqb, rmm, smg, pgv
tbn: mxx, sbh, vxd, jrp
sbh: tbn, ktl, hgr, qdt, msv
ckt: nmz, mjq, skp, sbj
vht: nmz, cdj, pms, jff
tpf: rjq, lxb, jmh, zhm, nrt
vdq: mfh, rdn, kzt, llv
qkp: kmh, pqm, gtm, qnq, pvj
kpb: hfd, mcj, dqb, rkt
hfd: kpb, fpj, nrs, ltn
dqb: kpb, hpp, jqs, scg
rkt: kpb, dvz, xbd, sgh
tct: smq, xbr, kgk, pfv
xbr: tct, xph, xhr, kkl
vbb: tlb, mpm, gkv, hcc
tlb: vbb, nzc, shg, lhb, gjb
lhb: jxz, mrl, ppr, tlb, hcv, nmd
rpx: jxz, tsg, qnq, zmp
tzd: qct, rxc, plq, bck
qct: tzd, vhx, gsl, xrl
plq: tzd, rzs, xrv, mkh, rzz
jgp: clc, bgb, mbd, spq
clc: jgp, thb, fcf, vkl
bgb: jgp, llr, dsx, xft
mbd: jgp, nsc, lhz, fgs
fsc: jtc, rdb, dtf, vdr, qmj
jtc: fsc, bjj, qfg, glm
dtf: fsc, prg, tqj, xjn
thv: cnn, xqg, tzz, rnt
rnt: thv, lpx, jmj, zng, mnk
fdq: gxr, vfb, msg, smq, scg, bgn, qnk
jpr: gxr, ppk, jpm, zqv
sng: prh, pkb, pzt, pbn
pzt: sng, qmp, mjc, csd
dqn: gqm, pzn, lnq, lxx, rnc
pzn: dqn, mkv, skq, tcx, zmp
lnq: dqn, nxx, fhr, qjd
xsx: qxx, ngr, zlc, mlc
qxx: xsx, cdj, nxv, lfb
qbz: zsf, tst, hcq, crl
hps: trs, jfc, qgb, fmv
trs: hps, gbn, jcp, rgc, vjt
jfc: hps, jjz, cdj, bxh, qhf
nxh: xkb, hmc, jfx, vgf
hmc: nxh, lpp, kmf, bfr
dtl: tjq, jtd, kqm, xmh
sgz: ttg, tpl, sbm, dbd, kcm
sbm: sgz, qjx, hcg, gqr
dbd: sgz, xgv, pqh, bhs, khr
kcm: sgz, fms, zpg, vhx
hpp: tzk, dxn, mjc, dqb
tzk: hpp, tgk, ztq, lcs, fgq
dxn: hpp, tvf, fvv, jjl
mjc: hpp, vqp, pzt, mxj
ztd: brq, jjd, lzp, tnb, ljl
jmm: qnf, zpx, hbz, glm
hbz: jmm, fjp, mzq, zqb, dtr, dsr
zvn: lqs, zfg, xhn, zqh, bcz
lqs: zvn, vpj, hhl, hgx, tpt
jgs: xxt, ggh, cdp, xfn
xxt: jgs, bxl, pxq, ccd, nlj
xfn: jgs, dqc, tck, qfr, bsh, xpf
gcx: xhh, qmr, mfl, txm
tdh: nfs, nrf, brv, krh
dbn: ffq, xph, ghh, zvc
gpl: rfq, cqb, djc, ftx
xhr: xbr, kpl, lxp, nmg, bmp
hxq: sfp, rpf, pzg, pgn, vmb
sfp: hxq, hvl, cpf, ptm
vmb: hxq, rns, xdh, rxc
nnr: kpg, xcr, hgr, pqg
kpg: nnr, nlg, dsd, nxr
xcr: nnr, mdk, zgq, lkh
sqp: mjv, bjb, jbm, qfr, nvj
snv: mxx, qpb, cnx, nsh
qjx: qxf, sbm, sct, ssv
gkr: hrv, ptf, czl, xhj
ptf: gkr, mxv, fdk, srs, dxh
xbk: jmk, vjg, vhj, pbq, kfj
jmk: xbk, qkv, jxj, nkq
lpx: rnt, qtb, qqt, scg
jmj: rnt, rdb, hlx, tcq
zng: rnt, smx, zxl, dcf
mnk: rnt, fmh, nrs, cmt
sbg: jjz, xtm, djc, qcz, czp
jjz: sbg, gbn, jfc, bjk
xgd: mss, bxh, nxv, jff
mss: xgd, tsb, jvc, svm
xbc: frf, vfb, spp, vvf, cth
frf: xbc, xjf, kdh, qdx
vvf: xbc, fsk, zcl, dtn
pps: qpv, ngg, qjh, lnl
qpv: pps, qfh, skp, hbn
ngg: pps, fts, cpd, tkd, pkm, skf
grd: rql, tkd, cmz, prf
rql: grd, tbx, pgz, zqh
gdv: jnf, bfr, bkb, hvc
fdl: pln, hrd, pnv, tss
pln: fdl, gkv, ngr, cms, zhv, pqk
hhs: qtx, kkr, mtq, bxx
mhf: fnz, nzm, zmd, tbs, xtm
fnz: mhf, bcv, qhf, kzh
zmd: mhf, cpf, tbx, vjv
tbs: mhf, ppm, bjk, bhx
rgd: dqz, rfq, hht, xtk
dsc: nkt, pjz, jkj, ntq
mdq: hnt, qln, rcb, jql
ppk: jpr, spx, dzp, lll
spx: ppk, kqm, fvd, hsn
jtd: gfd, nsh, vcp, dtl, gtg
nsh: jtd, mvf, lcb, snv, jbm
mxp: rxd, htk, zgd, mrp
bmv: khb, rvq, blb, vvg
khb: bmv, cfg, sfd, vzv
rvq: bmv, hpf, dxp, nlf, qtx
xtc: pgn, xgm, hzn, ssv
knk: chd, lbk, fcj, xjp
xpf: kfq, tgg, pkb, xfn
dxr: hkx, bzs, chm, kmf, ckf
vml: cfk, xgj, jrp, jbx
pdg: bbl, skq, pbq, fcj
bbl: pdg, kvl, pnv, zmm
dzf: vps, nhq, qlf, bhj
mtl: vps, pqh, gcv, pnv
tzg: fxp, djq, jtk, krh
mzf: pbl, tnf, vlf, btd
vlf: mzf, rqk, qgg, rxn
dqc: vgv, xfn, jfp, thj
thj: dqc, nmg, dxp, jkh, bhb, bzm
lzq: btj, knr, qhn, bgn, vqp, bsb, dnk
btj: lzq, cmf, sdf, rmt, kvn
vqp: lzq, hph, vxd, xbz, mjc
mvf: cjs, nsh, dfb, chm, tck
cjs: mvf, hbt, llz, ktt
dfb: mvf, qpb, nmg, hds, nqn
rgh: bjb, lqx, jrz, tqj
qjt: llr, bcs, nkh, rlq
tzp: vtj, zcl, nlr, zvc
rbt: rnn, bpz, mlc, vkc, jhd, rsk
rnn: rbt, vvl, zmq, mgv
bpz: rbt, qqq, hjx, txm
mlc: rbt, zgd, gmr, xsx
vkc: rbt, lcf, qmb, snr
jhd: rbt, xnn, hsp, pgd
pkm: trt, ngg, qjh, gnx, nfq
bzp: rjd, hmh, fvz, nkc
rjd: bzp, ggt, fmv, qsb
rnc: kgz, pqm, rdh, dqn
kgz: rnc, hgd, vth, scz, rhh
mtc: pfb, fbc, tcg, zcb, lgk
tcg: mtc, dld, gvl, qtx, pcc
tlc: qhn, cnd, fxb, pqg, bbv
cnd: tlc, ctc, qfj, kdh, jkr
sqs: fmz, qkd, xjn, jfx, hjs
qkd: sqs, lll, zsn, bxl
skq: pdg, nzq, zhv, pzn
vjg: vjt, jhf, xbk, mgx, lzl
cbn: tqt, pxq, bgl, zzj
tqt: cbn, nhr, rts, thq
hzb: rns, nkc, bjz, cks
pqh: rns, mtl, hcv, dbd, mpm, znd
xpm: csn, vjv, lbc, jxj
csn: xpm, pvc, sdx, lrz
tgk: rtg, qnp, tzk, nhr
rtg: tgk, gmj, kzt, tqz
qnp: tgk, blb, cxk, kfp, cfn
nhr: tgk, qxn, tqt, xxr, bkj
lbh: bpb, lzh, tgv, fvv
lzh: lbh, fkf, nqn, fvv
qmp: pzt, dcb, srv, vgf
dcb: qmp, gxh, hjh, csd
vgf: qmp, trb, gxp, nxh
mrl: ssl, qzn, glb, lhb
jpm: jpr, tpn, xpl, kdh
tpn: jpm, skl, gdn, zlq
kfj: nzm, qmb, jfd, xbk
xdg: nzm, jfr, mpm, rzz
njz: skm, qfg, rtm, ckg, ppp
cqb: gpl, bpm, qsn, cpf
bpm: cqb, txx, jkk, qfl
hgd: gnr, kgz, vbr, lxn, cpm
gnr: hgd, gmz, jrc, bnk, gqr, rpb
ppr: xqx, njn, lhb, mgx
mgx: ppr, vjg, xbg, rzn, fbj, hbx
xqt: fkr, rlq, nsc, fpk, mmg, gck, kkt
rlq: xqt, dlj, jgg, qjt
rmt: chm, btj, rsq, gfz
zjr: chm, rtt, qfg, kpl
skl: fxb, tpn, rcp, psl
rcp: skl, kgk, dlj, rcf, rdk, zsz
hhj: ljg, xpt, nss, cxr, qtx
rdn: fzd, tfm, vdq, hbl, tcq
hbl: rdn, kfq, rjq, fxb, kmb, vvg
tcq: rdn, jmj, gdn, bkj
slv: csh, fxr, jsn, rjp
szx: lqh, jzd, tlm, zxc
csq: lqh, lkt, nln, hbn
fbd: kgj, mfp, xgj, hvf
mfp: fbd, rhn, hjs, sfn
qrn: tjn, xsz, tqq, nns, pth, hpf
xsz: qrn, qdl, hgr, xmh
nns: qrn, lcq, xkb, fqt
cxk: qfz, klk, glr, qnp, glm
tjk: hds, dnf, jht, jkr
qcx: mhd, zmq, qsf, gcv
mhd: qcx, hbx, xcq, fvm
zmq: qcx, rnn, zxc, hnt, qqc
dxm: bhf, hpf, qtv, mjv, qfp
bxl: xxt, pmp, hlx, qkd, kdg
nsc: gxc, mbd, xqt, smg
smg: nsc, bgn, bjj, frq
zrr: dld, mdv, xrq, pcb
xrq: zrr, ckj, frm, nkt, pgx
xgm: xtc, srh, qxp, khr, cvs
srh: xgm, pvc, djq, fpd
khr: xgm, jcp, hcq, dbd
cvs: xgm, snc, ncg, zcr
jfx: nxh, sqs, dsz, nlg, jqh, hmq, gbp
jqh: jfx, sgc, hbs, hzk, tqj
cfg: xqz, zzf, khb, lss
xqz: cfg, ppt, kzm, hsn
klb: ndq, zqv, nxr, bnh
gcg: ndq, psn, rfp, qqp, sfd
thf: mlf, rzz, gzq, rqx
pgx: nzl, xsj, pmv, xrq
fbj: mgx, gbr, rhh, chz
hbx: mgx, mhd, qlf, klr, txj, fvm
kmb: qtv, mdv, hbl, srq
qtv: kmb, lxp, kgj, dxm
mcv: ppl, pmp, qdt, sdp, jkj, ctl
hph: vqp, jdg, spq, hcl
rtm: ckj, cch, jfv, njz
ckj: rtm, qtb, xrq, jht
jdg: vdr, hph, bmp, dgc
hbt: fcc, jzf, zhr, cjs
fcc: hbt, ktt, znz, fxg, dcf, ppp
jzf: hbt, ngz, pkh, lfc
ksg: jqs, kkl, ljl, psz
jqs: ksg, bkr, dqb, pjh, lrb
mxq: tfc, nlg, fpj, djb
tfc: mxq, ggh, psl, tqj
nrf: tdh, xpz, npk, mjg
mjg: nrf, hsx, xvv, mqd, crc
zxq: zlq, xsg, gbp, xbt
frm: ggk, mjv, xrq, fvv
xfr: glt, jkf, jdk, gqm, nkq, tsf
vhj: vsb, xbk, pkg, dqp
vsb: vhj, fxr, spn, jfd
pkg: vhj, vtl, nln, rcs
dqp: vhj, qds, fmv, xgv, nmf, crl
ngz: jzf, trb, gzk, kpk
mcp: sjz, jjl, lhm, zqr, tgv
jjl: mcp, xdr, lnm, pnh, dxn
cjz: qtg, pnb, xjf, vzv
xjf: cjz, nlb, frf, bzv, bsh
gtm: fmd, qkp, tdq, vcz
snc: qdp, pst, cvs, bjk, tbx, kps
qdp: snc, fkc, vzd, zdv, hzn
pst: snc, gpj, mzn, crj, zxc
fms: kcm, mzn, hgx, xlv, zpg
hgx: fms, lfg, lqs, rdj, crk, nbk, dpg
rdj: tkh, fxr, hgx, hdq
fxr: rdj, vsb, slv, hcq, tsg
lxp: qtv, vsq, xhr, ndz
vsq: lxp, mpl, hqx, zdm
rzs: plq, pdq, cmq, msk, pqk
fkf: mtr, lzh, nkh, vmh
mtr: fkf, xbt, rqm, ddz
zjc: pgv, prg, tjb, pzj
pgv: zjc, vzb, pqv, tgc, frq
prg: zjc, dsz, dtf, ppp
ddh: qlg, tnr, gjc, qcz
lzp: hbg, dsd, ztd, zxj
mtp: rcs, pbq, tmb, lrr
rcs: mtp, pkg, jkf, rxc
tmb: mtp, pvj, pbq, qjd
mkv: mrp, pzn, qgm, fpd, tff
mrp: mkv, zpg, mnh, lcm, mxp
fpd: mkv, vzl, jnp, srh
blb: bmv, vbt, gsz, qnp
gsz: blb, cfn, pvz, vmq, dlc
cxb: hbq, vvn, brq, rft
vch: drm, pdq, qhg, tsf
grl: mfn, ppt, vzb, tnb
vzb: grl, pgv, hlx, hcl
bng: pbq, dvg, ddb, bsj
qkh: fmd, zdd, hfk, kks
zdd: qkh, rcb, hcg, tsb, lxs, nfq, crl, ctx
klr: hbx, qqq, gkq, bjk
txj: hbx, gjb, czl, lqh, tzx, frh
msg: xnv, fdq, zxj, pmp
bcs: sxv, qjt, vsc, vlh
jcx: sxv, jpf, ghh, lcq
ndv: xqf, hbc, jtr, svm, gkq
gkq: ndv, xgv, klr, shz
bgl: vfc, zhm, nss, cbn
gkv: vbb, pln, shg, kvl
nln: pkg, qpj, csq, jff
xgj: tqh, fbd, vml, qqt
qrt: mzm, zsn, glr, mcl
zsn: qrt, qkd, gtg, lst, spp
qff: jnf, lll, bkg, htj
mqh: ggh, qfj, lgj, cxl, kfp, kvb
lhz: mbd, qtg, ljl, nlf
trp: xqg, zqr, rtt, nlf
dkh: pnd, zxj, djx, dsr
cxl: pnd, kqx, lcq, mqh
hmt: pqp, grx, txx, zbl
grx: hmt, hcb, hbc, znn, rhv, xcg
txx: hmt, glb, nbk, bpm, mqb, gnc, zcr
lcf: vkc, nhq, btd, gjg
kgk: zfz, kfs, rcp, bkr, tct, srv
zfz: kgk, cxr, jgq, kxx
bkr: kgk, jqs, kqx, fjm
gzq: qnq, qbh, thf, vhx
lzl: vjg, gnx, tsj, tzx
tzx: lzl, qbb, sbn, txj, qkm
mqd: mjg, ndc, cpm, rzz, dhl
crc: mjg, cks, jmr, gbl
jrp: zcl, tbn, kvm, vml, lvv, gck
zcl: jrp, qqt, vvf, tzp
kvm: jrp, xnd, xdr, bkj
jkf: xfr, qcn, rcs, mgv, dmc
qcn: jkf, vrk, qdq, stp
cfn: gsz, dql, djm, qnp
bjj: smg, zdj, jtc, qdt
zdj: rfp, bjj, smx, vkl
bbj: nrh, fpb, xdr, nzl, rnq
nrh: bbj, ktt, ddz, hkq
fpb: bbj, dlj, sdf, knr
dss: qnz, ssv, pbc, zlc
qnz: dss, zgm, zdv, xvv
ssv: dss, fhv, qjx, phs, xtc
hcv: pqh, jzd, lhb, jnj
smx: zdj, xfc, phr, zng
vsc: bcs, glm, cmf, mjv
bhs: rrf, crk, ntt, dbd
pvc: srh, mfl, znm, csn
mfl: pvc, pbl, dpv, gcx, gjg
qfh: lzg, qpv, bxh, znn, pkj, ftx, xcg
bxh: qfh, jfc, xgd, cmz, hhl
znn: qfh, qds, grx, cks
lcm: stv, mrp, jtr, znd
xpt: hhj, qxn, kfq, zxl
htk: nxx, fhl, nxv, shz, mxp
nxv: htk, qxx, xgd, hbc
fzg: tzr, kzm, msv, rdm, nlj
kzm: fzg, xqz, hrt, xvt, cfh
thz: xbg, xgn, rqk, pgz
rqk: thz, qxf, vlf, kcr
rsq: nlg, rmt, jss, zpt
jxc: glp, tzr, cth, lkh
glp: jxc, sdp, kxx, xtd, gtg
xtd: glp, rjq, tgg, jnf
qmb: bhx, ghv, kfj, vkc, mkk, tdq
bhx: qmb, tbs, rpp, ftx
jpf: jcx, ztq, fpk, nlj, ctl
lrn: qsp, jrq, mpb, qbs
qsp: lrn, vpj, gjc, ljn
qfr: sqp, fmz, xfn, xkn
ttc: kvb, crp, zsz, xsj
kvb: ttc, djx, nrs, mqh, llv
zsz: ttc, cmk, rgs, rcp
ktt: cjs, nrh, fcc, dtr
vrc: ccb, zbx, mxj, bfq
ccb: vrc, phr, cch, nlf
gdn: tpn, lxb, tcq, sfz
qbb: qzh, vkf, tzx, jjx, glh
glh: qbb, cqc, rbj, rgc, sld
qtb: lpx, ckj, pbn, zbf
tnb: ztd, grl, bkb, xbz
dzp: hqj, zqr, ppk, lrb
lrb: dzp, cxr, pfs, cnn, jqs, mcl
hbn: fpc, qpv, csq, fmb, kzh
jdk: nxf, jtk, xfr, hsr
nxf: jdk, kzp, tqd, snj
jtk: jdk, qkx, fvf, tzg
lcq: nns, jcx, cxl, sgh
cdj: qxx, vht, krn, jfc
dqm: sjk, cmk, kfq, stb, pcc
rdk: hqn, rcp, shh, flp
hqn: rdk, gvl, jss, zzj
fpj: mxq, hfd, pmv, dsf
hpf: rvq, dxm, qrn, sjz
gvl: tjn, tcg, hqn, svn
svn: gvl, xxr, ddz, pcv
ngr: pln, qtk, xsx, xjp, ftx
qtk: ngr, csh, ggt, mgf
tgv: vhf, mcp, klk, lbh
tlm: fvz, ksx, lrz, szx
qzr: fhv, npk, lfg, zsf, scz, spr
lfg: qzr, hgx, jnj, nzs, qkm
scz: qzr, bcv, kgz, jfd
nkh: fkf, srv, xpl, qjt
hhl: cpf, lqs, bxh, gsr
pmp: tfm, msg, bxl, mcv, mpl
mpl: pmp, dcp, kkl, vsq
gcd: zgz, jbx, fqt, lzv
psn: gjf, fkd, brd, gcg
xlv: fms, gnc, nzk, vlq, xpn, dpv
gnc: xlv, pzv, lnl, txx
qdl: zbf, klv, xsz, fjf
fjf: qdl, ctc, flp, gxh
pdf: rns, sqb, bhn, blg
vzv: cjz, ppt, khb, sjk
lgk: mfc, mtc, sgh, ndz, tvx
sgh: lgk, lcq, dhp, rkt, mlt, zpx
ndz: lgk, mmg, llv, lxp
nxr: jfv, klb, xsg, pjz, kpg, bxx
jfv: nxr, ggx, jjj, rtm, vcr
xsg: nxr, jht, zxq, tqj
pjz: nxr, dsc, hzc, rtt
vrk: ssk, ptz, ggt, qcn
cxr: zfz, lrb, hhj, ctl
vsk: kbs, xqg, mcj, tgc
nkc: bzp, ftr, hzb, jnj
vkb: lfm, bfh, tck, xsl
pcc: fkq, zdm, tcg, dqm
rlf: vgx, zfg, rgc, dxh
nbk: hgx, txx, ssc, gnt
lst: mgd, zsn, dqj, dtr
blg: pdf, ggt, fhr, vvl
vvl: blg, qdq, qpj, rnn
kqm: spx, dtl, ppl, lpc
hdq: xcq, rdj, jxz, pms
pms: hdq, vht, vtn, tnr
vlc: bhn, krh, bnq, ctv
lqx: msh, bpb, rgh, ckf
ppm: tnr, dlm, xrv, tbs
jcp: trs, tsp, khr, pvj
pvj: jcp, tmb, knq, plg, qkp
xmh: dtl, xsz, zcb, pxq
skf: ngg, msk, dlm, mgv
msk: skf, jsn, bhj, rzs
cnx: snv, mtb, hjs, qxz
fvd: spx, hzc, xtg, pfv
zpg: mrp, kcm, fms, gdx
vdn: zrv, hpd, qfj, qmj
ktk: mkh, ggm, tqd, ftp, tsk
ggm: ktk, qhf, qsb, mtf
sgc: jqh, vkk, gbp, mcl
dnk: kcc, mfh, lzq, xkn
pxc: ftr, bnv, dqf, jkk
ggx: xbd, dpl, jfv, vlh, rmr, vfc, qqg
xbd: ggx, fpk, gmn, rkt
rmr: ggx, pvf, sfd, gmn
fpk: xqt, jpf, rdm, xbd
hcc: rhh, vbb, skp, dxh
lll: ppk, qkd, zqt, qff, ttm
brd: prr, lss, gmj, fxg, psn
lbk: dqz, cmz, knk, bvm, zxc
phr: smx, ccb, tkf, vkq, bkj
gzc: mkh, zkb, bhc, qbs
jzd: nzs, szx, hcv, cks
vmh: xkn, spq, fkf, xnd, zvc
xkn: vmh, qfr, dnk, hgk
spq: vmh, xbt, jgp, hph, vkl
zvc: vmh, tzp, mpx, dbn
jfr: xdg, pnz, rpp, tsx, qqc
jvc: nmd, qzh, xxl, njn, mss
pqv: pgv, kkt, tjn, dng
qds: mvx, ksx, znn, dqp
bsh: pzj, xjf, ctl, xfn
qpj: vvl, jmc, hjx, zfx, nln
zfx: qpj, xcn, glt, mgv
dvz: pnd, jrz, fnb, pnb, rkt
jrz: dvz, vvn, rgh, kkt
dcp: dhp, zjf, mpl, nrs
nrs: dcp, mnk, kvb, hfd, dsf
gsr: bxf, vzd, jdm, hhl
qlb: nkq, gjg, pvn, fbt
nkq: qlb, xfr, khh, jmk
gjg: qlb, stl, lcf, mfl
cch: fcs, ccb, rtm, jkj
mtb: mkg, pnh, blc, cnx
nhq: pjf, vbr, dzf, lcf
nlb: ccd, mxx, xjf, jbj
bbb: klv, jgg, xcv, vgr
btd: kcr, lxx, crs, kqr, lcf, mzf, ljn
ljn: btd, qsp, bnv, gpj
fsk: ppc, jlb, hqx, vvf
fgq: qtz, xsd, ggk, tzk
qtz: fgq, cmt, zbf, zcb
xsd: fgq, jbx, kmz, pcv
hql: ntq, pfb, gvb, hpd
ntq: hql, dsc, sdp, prr
gvb: hql, fqt, qxr, chs
dsr: blc, zqt, dkh, hbz
kvn: btj, mjk, bcb, ckg
bcb: kvn, pvf, gfl, djb
qqq: sbj, klr, bpz, vzl
sbj: qqq, qhg, csh, jql, ckt
gjh: fbc, bfr, jss, bgc
jss: gjh, rsq, cns, zst, hqn
fvf: fmd, rsk, jtk, lrz
lrz: fvf, cpm, csn, tlm
qhf: rhh, fnz, jfc, ggm, mtf
kvl: fvg, vgx, gkv, bbl
qdt: mcv, bjj, nvb, sbh
glr: lxb, cxk, kmz, qrt, jvx
mkk: zlc, mgf, qmb, pns
mgf: mkk, rrf, qtk, lbc, vkh
xgq: mdv, zqb, bgc, fvv
pgd: jhd, ssk, pfm, dpk
sbn: lfx, tzx, tkh, dgl
lfx: sbn, trl, jmc, vjv
knq: nhc, csc, kzl, nfq, jrq, pvj
qjc: ghv, bxv, mjq, ccj
cms: pln, czp, fbq, gdx
fmv: hps, spn, dqp, rjd, vtl
spn: fmv, rbj, vsb, hvn
qqt: lpx, xgj, ddq, cmk, zcl, blv
rzz: xdg, mqd, ftr, thf, plq
kzp: stv, nxf, rpb, gst, tsq
jkh: ghh, tkf, thj, rlr
pdq: fcj, rzs, vch, tsk
fcj: pdq, qrz, knk, pdg, zmp
tsk: pdq, lkt, ktk, pgn, gqn
rtt: trp, pjz, zjr, lch, fjp
fbq: drm, tsj, rzn, cms
ctv: hcn, vlc, ksb, cpd
sdx: jff, csn, gsq, vdb
jff: sdx, nln, vht, xnj, xgd, zns
kkl: mpl, ksg, xbr, qfg
mdx: fjm, zlq, bzv, lch, fzm
cmk: jkr, qtg, qqt, dgc, dqm, zsz
jkr: cmk, rmm, cnd, tjk
xmm: mhg, csh, qkx, fvm
tmz: xcn, zvx, pzv, cvc
mhp: ndq, pkb, mfc, xjn
tsg: rpx, krn, ghv, fxr
pjj: vrs, xnf, hls, xqg
rgc: msm, trs, gsq, rlf, glh
lzc: nzc, znq, nfl, vlm
dxh: nzm, ptf, hcc, rlf
tsb: zdd, mss, jtr, rxv
cmq: vth, rzs, rbq, qkx
rbq: cmq, zmm, xgv, hrd
hpd: vdn, dpl, hql, mht, fjp
zxc: zmq, lbk, chd, szx, pst
tvf: pjh, zxj, dxn, xdf
pjh: tvf, nll, xnf, jqs
rxv: tsb, qpg, ftp, sld
qfj: vdn, gmn, mqh, flq, flp, cnd
flp: qfj, rdk, rmm, fjf
qfg: kkl, njz, jtc, zjr
qsb: txm, rjd, gsl, ggm
txm: qsb, znq, bpz, gcx
jkq: vzh, jjd, pfs, mzm, gjf
pfs: jkq, lrb, gbp, pfv
srq: fxg, kmb, xsl, lqg
xsl: srq, xpl, vkb, ddq
tsx: rhv, qtp, jfr, hht
qtp: tsx, snr, qkv, xhn
bfq: stb, vrc, xxr, fzm
fzm: bfq, prd, mdx, pnb
hzg: jmh, kfs, xdl, qnf
ptm: zhv, hnt, sfp, bcz
mmg: xqt, hls, lbs, ndz
kzt: rtg, vdq, bnh, xgh
vmq: crp, hqx, gsz, vvg
brv: cjt, tdh, zhg, kqr, mpm
hjs: kkr, cnx, kkq, sqs, mfp
gcv: ftp, mtl, ztb, qcx
mqb: gqr, gnx, vtm, rsk, txx
gqr: mqb, gnr, sbm, dqf
krq: stv, kfh, xpp, rrf
kfh: krq, phs, vlm, rjp
hvc: kbs, dpf, gdv, hkx
lkh: zpx, jxc, bxb, xcr
mqr: xkg, rns, rjp, tqd
cxd: dlc, kqx, lpc, vfc
dlc: cxd, dtn, gsz, bdv, lpc
zcr: cvs, bxm, txx, ncg
qhg: vch, hsr, sbj, njj, vhx
hsr: qhg, tsp, zdv, jdk
njj: qhg, xvv, xpp, rqx
bxv: zvg, gnt, qjc, rxc
dtn: dlc, vvf, lhh, dxp
stl: cdt, gjg, vdb, bxp
nvj: sqp, nkt, xhv, bbq
gnt: fts, rbl, nbk, bxv
tdq: qmb, ddb, gtm, qvb
nlr: gfl, tzp, fdh, xvt, xtg
gfz: ljg, tlk, rmt, tck
gjc: qsp, vkh, ddh, jnz
jnz: gjc, plg, bsj, gqn
ttm: vbt, lll, bdv, tkf
bxx: tjs, zxl, hhs, nxr
hvn: spn, hnc, jdn, ctx
zmm: jrc, rbq, bbl, nfb, xdz
glm: jmm, hvf, cxk, vsc, jtc
hvf: glm, vxd, pnb, xxv, dpl, fbd
llv: rqm, kvb, ndz, vdq
vkl: vxn, fqm, zdj, spq, clc
kpk: qgp, ngz, vkk, mkg, xcl
qgp: kpk, pfv, mcl, dng
vhx: gzq, lhj, kcm, qhg, qct
zpt: blc, rsq, hbq, bpb
drv: fjh, xvv, spr, bnk
spr: drv, sfs, qzr, xhh
gmr: pqm, mbq, lzg, mlc
sct: dqz, qjx, tsj, bck
cks: crc, jzd, hzb, xcn, znn
cqc: glh, srs, xjp, jkk, tlh
xjp: cqc, ngr, knk, pqp
qbs: dqf, zmp, gmz, gzc, lrn
tck: xfn, mvf, gfz, vkb
kjn: bjf, rxd, qsf, rzm, ssl
zdm: bkg, rcf, vsq, pcc, hvm, nbj
bkg: zdm, qff, jnf, pkh, lvv
xzj: mbq, bcv, msm, gbr
scg: fdq, dqb, kxx, lpx
qqc: trl, jfr, vjv, zmq, bcz
znd: lcm, msm, pqh, ksh
gbp: zxq, sgc, jfx, pfs
lrr: mtp, rbl, rpd, bnk
cvc: fvz, tmz, mxv, rdq
bgc: pbn, zrc, xgq, gjh
plg: pvj, jnz, vzd, dhl
dhl: plg, bdf, qgm, mqd, gdx
blv: qqt, cth, klv, xpl
ksh: trt, sfs, znd, qcz
tsq: kzp, hcn, zfd, fvm
jkj: pmv, dsc, mcv, cch
jsn: xdh, slv, xpz, msk
snj: lkt, qzn, nxf, hrv
fjp: hpd, psl, rtt, hbz
qjd: lnq, tmb, pnz, gbr
vvg: vmq, djm, lpp, bmv, hbl
tqj: tfc, dtf, jqh, trz, rgh, xsg
kdh: frf, fcf, jpm, cnd
tmp: sjk, dsx, fzd, hxr
pns: xnj, kmh, mkk, trl, npk
mcl: hmq, lrb, qrt, sgc, xtg, qgp
qdx: kmz, frf, fdh, xnf
dsf: qnk, gxh, nrs, fpj
qnk: dsf, pjv, fdq, bhf
gxh: dsf, hrt, fjf, dcb
kkt: pqv, xqt, jrz, rlr, jjd
rlr: kkt, zlq, jkh, zxj
nlj: fzg, xxt, zxj, jpf
hsn: xqz, spx, pcb, zhm
ctl: bsh, mcv, jpf, cxr
cmt: mnk, kxt, cdp, qtz
sfz: knr, xnf, gdn, sjz, bmp
bck: qlg, tzd, sct, pqk
pqk: bck, vtl, pln, rzs
xtg: vms, fvd, nlr, mcl, xjz
tqz: rtg, xvp, hxr, ktl, kfs
nlf: trp, lhz, ccb, rvq
pfv: pfs, hlx, qgp, fvd, tct, dql
dmc: ldk, jkf, ttg, gzd, qbh
bkj: tcq, kvm, phr, nhr
fvm: qpg, tsq, hbx, mhd, xmm
nqn: zrv, dfb, lzh, rqm, spk
zns: lqr, jbj, vvn, jfp, jff
jbj: zns, mmv, thq, mht, nlb
jfd: qtf, kfj, scz, vsb
jqj: vcr, gzk, mbc, bbv
hpv: bkb, pxq, qpq, hgk
hgk: hpv, jjm, pqg, xkn
ftx: qfh, ngr, plb, gpl, bhx
tgc: vsk, qhn, ppl, zqv, pgv
qkm: xpp, bhc, pjf, tzx, lfg, szr
gdx: zpg, vgn, cms, khh, dhl, mrj
cfh: prd, rgs, kmf, kzm
ckf: fxq, lqx, dxr, klk
gqn: tsk, lfb, vlm, fdk, jnz
lfb: gqn, qxx, jdm, lxs
kzh: pvn, fnz, hbn, ckv
xcg: vfn, grx, xrl, qfh
dpg: hgx, krn, ptz, qjh
crl: zdd, krn, dqp, qbz
fvv: dxn, xgq, hbs, lzh, frm, gzk, lbh
mtf: drm, ggm, qhf, tsz
ctx: hvn, tnr, zdd, mzn
bcz: zvn, ptm, znp, qqc
ppp: fcc, vgv, prg, njz
qvm: stv, vlq, kpd, tss
htj: qff, bfr, bsb, hqx
